Aaron Tippin|aaron tippin
Alicia Keys|alicia keys
Amel Larrieux|amel larrieux
Angie Stone|angie stone
Brian McKnight|brian mcknight
Carl Thomas|carl thomas
Carolyn Dawn Johnson|carolyn dawn johnson
Chris Cagle|chris cagle
Clay Walker|clay walker
Clint Black|clint black
David Gray|david gray
Eminem|eminem
Erykah Badu|erykah badu
Faith Hill|faith hill
Fatboy Slim|fatboy slim
Foo Fighters|foo fighters
George Strait|george strait
Gerald Levert|gerald levert
Joe|joe
John Michael Montgomery|john michael montgomery
Kandi|kandi
Keith Urban|keith urban
Kenny G|kenny g
Kid Rock|kid rock
Lenny Kravitz|lenny kravitz
Limp Bizkit|limp bizkit
Madonna|madonna
Mariah Carey|mariah carey
Martina McBride|martina mcbride
Mint Condition|mint condition
No Doubt|no doubt
Pearl Jam|pearl jam
Phil Vassar|phil vassar
Prince|prince
Q-Tip|q-tip
R. Kelly|r. kelly
R.E.M.|r.e.m.
Rage Against the Machine|rage against the machine
Reba McEntire|reba mcentire
Sara Evans|sara evans
Sonique|sonique
Terri Clark|terri clark
Tim McGraw|tim mcgraw
Toby Keith|toby keith
Tracy Byrd|tracy byrd
Tracy Lawrence|tracy lawrence
Train|train
Travis Tritt|travis tritt
Trisha Yearwood|trisha yearwood
dave hollister|dave hollister
donell jones|donell jones
leann rimes|leann rimes
savage garden|savage garden
toni braxton|toni braxton
